20 5 5
 ####
    #
##  #
### #
###  
1 5 5
 ####
    #
##  #
### #
###  
20 5 5
 ####
 #   
 # # 
 #   
   # 
30 10 10
   #      
  ## # # #
  ## # # #
#      # #
 # ##### #
#  ##    #
# #    ###
# # # #   
# ###  # #
# ###
0 0 0
